#module 0 size: 33 bs: 0.000188764
1 2 5 7 8 11 15 16 21 24 27 28 33 40 43 45 51 62 67 69 73 74 78 79 80 84 85 87 88 89 90 91 97 
#module 1 size: 32 bs: 0.000110722
1 3 6 9 11 14 16 17 20 23 24 25 29 30 31 32 35 36 43 47 56 58 63 68 78 80 88 89 90 98 99 100 
#module 2 size: 26 bs: 0.000157212
4 8 12 18 19 22 34 41 42 44 45 50 51 52 55 61 62 64 70 75 77 81 83 84 94 96 
#module 3 size: 21 bs: 1.47483e-10
4 19 26 38 49 53 54 55 61 64 66 70 71 72 76 81 82 86 92 93 96 
#module 4 size: 3 bs: 0.108077
39 48 95 
#module 5 size: 4 bs: 0.00371749
37 59 60 65 
#module 0 size: 36 bs: 3.6066e-05
1 2 5 7 8 11 15 16 21 24 27 28 33 40 42 43 45 51 62 67 69 73 74 77 78 79 80 84 85 87 88 89 90 91 94 97 
#module 1 size: 26 bs: 0.000194609
4 8 12 18 19 22 34 41 42 44 45 50 51 52 55 61 62 64 70 75 77 81 83 84 94 96 
#module 2 size: 21 bs: 1.71246e-10
4 19 26 38 49 53 54 55 61 64 66 70 71 72 76 81 82 86 92 93 96 
#module 3 size: 5 bs: 0.00274701
9 10 13 31 46 
#module 4 size: 4 bs: 0.0503978
36 47 58 99 
#module 0 size: 30 bs: 1.44426e-05
1 3 6 11 14 16 17 20 23 24 25 29 30 32 33 35 43 56 63 68 69 78 80 85 88 89 90 97 98 100 
#module 1 size: 34 bs: 9.91784e-05
1 2 5 7 8 11 15 16 21 24 27 28 33 40 43 45 51 62 67 69 73 74 77 78 79 80 84 85 87 88 89 90 91 97 
#module 2 size: 26 bs: 0.00019461
4 8 12 18 19 22 34 41 42 44 45 50 51 52 55 61 62 64 70 75 77 81 83 84 94 96 
#module 3 size: 21 bs: 1.47483e-10
4 19 26 38 49 53 54 55 61 64 66 70 71 72 76 81 82 86 92 93 96 
#module 0 size: 30 bs: 1.32923e-05
1 3 6 11 14 16 17 20 23 24 25 29 30 32 33 35 43 56 63 68 69 78 80 85 88 89 90 97 98 100 
#module 1 size: 34 bs: 9.91783e-05
1 2 5 7 8 11 15 16 21 24 27 28 33 40 43 45 51 62 67 69 73 74 77 78 79 80 84 85 87 88 89 90 91 97 
#module 2 size: 27 bs: 0.119052
4 5 8 12 18 19 22 34 41 42 44 45 50 51 52 55 61 62 64 70 75 77 81 83 84 94 96 
#module 3 size: 15 bs: 7.4133e-08
26 38 49 53 54 55 66 71 72 76 82 86 92 93 96 
#module 4 size: 7 bs: 0.000246657
37 39 48 59 60 65 95 
#module 5 size: 4 bs: 0.00011153
10 13 31 46 
#module 0 size: 30 bs: 1.44585e-05
1 3 6 11 14 16 17 20 23 24 25 29 30 32 33 35 43 56 63 68 69 78 80 85 88 89 90 97 98 100 
#module 1 size: 34 bs: 5.2178e-05
1 2 5 7 8 11 15 16 21 24 27 28 33 40 43 45 51 62 67 69 73 74 77 78 79 80 84 85 87 88 89 90 91 97 
#module 2 size: 27 bs: 6.8782e-05
4 5 8 12 18 19 22 34 41 42 44 45 50 51 52 55 61 62 64 70 75 77 81 83 84 94 96 
#module 3 size: 9 bs: 1.78599e-05
26 39 48 54 59 60 65 66 95 
#module 4 size: 5 bs: 0.00274701
9 10 13 31 46 
#module 0 size: 36 bs: 8.38279e-06
1 2 5 7 8 11 15 16 21 24 27 28 33 40 42 43 45 51 62 67 69 73 74 77 78 79 80 84 85 87 88 89 90 91 94 97 
#module 1 size: 26 bs: 3.6066e-05
4 8 12 18 19 22 34 41 42 44 45 50 51 52 55 61 62 64 70 75 77 81 83 84 94 96 
#module 2 size: 21 bs: 0.000194609
4 19 26 38 49 53 54 55 61 64 66 70 71 72 76 81 82 86 92 93 96 
#module 3 size: 4 bs: 1.71245e-10
10 13 31 46 
#module 4 size: 12 bs: 0.00011153
14 17 25 29 32 35 36 47 56 58 68 99 
#module 0 size: 30 bs: 1.44426e-05
1 3 6 11 14 16 17 20 23 24 25 29 30 32 33 35 43 56 63 68 69 78 80 85 88 89 90 97 98 100 
#module 1 size: 34 bs: 9.91784e-05
1 2 5 7 8 11 15 16 21 24 27 28 33 40 43 45 51 62 67 69 73 74 77 78 79 80 84 85 87 88 89 90 91 97 
#module 2 size: 26 bs: 0.000194609
4 8 12 18 19 22 34 41 42 44 45 50 51 52 55 61 62 64 70 75 77 81 83 84 94 96 
#module 3 size: 16 bs: 2.40485e-07
26 38 49 53 54 55 64 66 71 72 76 82 86 92 93 96 
#module 4 size: 9 bs: 0.00391052
26 37 39 48 54 59 60 65 95 
#module 5 size: 5 bs: 0.00274701
9 10 13 31 46 
#module 0 size: 36 bs: 3.6066e-05
1 2 5 7 8 11 15 16 21 24 27 28 33 40 42 43 45 51 62 67 69 73 74 77 78 79 80 84 85 87 88 89 90 91 94 97 
#module 1 size: 38 bs: 5.82777e-05
1 3 6 9 11 14 16 17 20 23 24 25 29 30 31 32 33 35 36 43 47 56 58 63 68 69 78 80 85 87 88 89 90 91 97 98 99 100 
#module 2 size: 26 bs: 0.00019461
4 8 12 18 19 22 34 41 42 44 45 50 51 52 55 61 62 64 70 75 77 81 83 84 94 96 
#module 3 size: 21 bs: 1.47484e-10
4 19 26 38 49 53 54 55 61 64 66 70 71 72 76 81 82 86 92 93 96 
#module 4 size: 3 bs: 0.108077
39 48 95 
#module 5 size: 4 bs: 0.00371749
37 59 60 65 
#module 0 size: 36 bs: 8.36202e-06
1 2 5 7 8 11 15 16 21 24 27 28 33 40 42 43 45 51 62 67 69 73 74 77 78 79 80 84 85 87 88 89 90 91 94 97 
#module 1 size: 26 bs: 3.6066e-05
4 8 12 18 19 22 34 41 42 44 45 50 51 52 55 61 62 64 70 75 77 81 83 84 94 96 
#module 2 size: 10 bs: 0.000302453
26 37 39 48 54 59 60 65 66 95 
#module 3 size: 21 bs: 0.0060646
4 19 26 38 49 53 54 55 61 64 66 70 71 72 76 81 82 86 92 93 96 
#module 4 size: 13 bs: 0.0263118
9 10 13 17 29 31 32 36 46 47 58 68 99 
#module 0 size: 36 bs: 3.6066e-05
1 2 5 7 8 11 15 16 21 24 27 28 33 40 42 43 45 51 62 67 69 73 74 77 78 79 80 84 85 87 88 89 90 91 94 97 
#module 1 size: 38 bs: 5.82777e-05
1 3 6 9 11 14 16 17 20 23 24 25 29 30 31 32 33 35 36 43 47 56 58 63 68 69 78 80 85 87 88 89 90 91 97 98 99 100 
#module 2 size: 26 bs: 0.00019461
4 8 12 18 19 22 34 41 42 44 45 50 51 52 55 61 62 64 70 75 77 81 83 84 94 96 
#module 3 size: 21 bs: 1.47483e-10
4 19 26 38 49 53 54 55 61 64 66 70 71 72 76 81 82 86 92 93 96 
