#module 0 size: 70 bs: 7.21645e-15
8 9 10 11 12 18 19 20 21 22 23 26 28 30 32 33 34 37 38 39 40 41 42 43 45 46 48 49 50 51 52 53 54 55 56 57 59 60 61 62 63 64 65 66 68 70 71 72 74 75 76 79 80 81 82 83 84 85 86 87 88 92 93 94 95 96 97 98 99 100 
#module 1 size: 51 bs: 1.35323e-08
1 2 3 4 5 6 7 12 13 14 15 16 17 18 19 23 24 25 26 27 28 29 30 31 32 33 34 35 36 37 42 44 45 47 48 51 53 56 58 65 66 67 69 76 77 78 80 89 90 91 99 
#module 0 size: 70 bs: 0.041329
8 9 10 11 12 18 19 20 21 22 23 26 28 30 32 33 34 37 38 39 40 41 42 43 45 46 48 49 50 51 52 53 54 55 56 57 59 60 61 62 63 64 65 66 68 70 71 72 74 75 76 79 80 81 82 83 84 85 86 87 88 92 93 94 95 96 97 98 99 100 
#module 1 size: 13 bs: 0.00278753
2 3 6 13 14 24 25 47 58 69 77 78 89 
#module 0 size: 70 bs: 0.041329
8 9 10 11 12 18 19 20 21 22 23 26 28 30 32 33 34 37 38 39 40 41 42 43 45 46 48 49 50 51 52 53 54 55 56 57 59 60 61 62 63 64 65 66 68 70 71 72 74 75 76 79 80 81 82 83 84 85 86 87 88 92 93 94 95 96 97 98 99 100 
#module 1 size: 13 bs: 0.00278753
2 3 6 13 14 24 25 47 58 69 77 78 89 
#module 0 size: 70 bs: 0.0412367
8 9 10 11 12 18 19 20 21 22 23 26 28 30 32 33 34 37 38 39 40 41 42 43 45 46 48 49 50 51 52 53 54 55 56 57 59 60 61 62 63 64 65 66 68 70 71 72 74 75 76 79 80 81 82 83 84 85 86 87 88 92 93 94 95 96 97 98 99 100 
#module 1 size: 13 bs: 0.00278753
2 3 6 13 14 24 25 47 58 69 77 78 89 
#module 0 size: 70 bs: 0.0413291
8 9 10 11 12 18 19 20 21 22 23 26 28 30 32 33 34 37 38 39 40 41 42 43 45 46 48 49 50 51 52 53 54 55 56 57 59 60 61 62 63 64 65 66 68 70 71 72 74 75 76 79 80 81 82 83 84 85 86 87 88 92 93 94 95 96 97 98 99 100 
#module 1 size: 13 bs: 0.00287191
2 3 6 13 14 24 25 47 58 69 77 78 89 
#module 0 size: 70 bs: 0.0413034
8 9 10 11 12 18 19 20 21 22 23 26 28 30 32 33 34 37 38 39 40 41 42 43 45 46 48 49 50 51 52 53 54 55 56 57 59 60 61 62 63 64 65 66 68 70 71 72 74 75 76 79 80 81 82 83 84 85 86 87 88 92 93 94 95 96 97 98 99 100 
#module 1 size: 13 bs: 0.0028719
2 3 6 13 14 24 25 47 58 69 77 78 89 
#module 0 size: 27 bs: 7.21645e-15
1 2 3 4 5 6 7 14 15 16 17 24 25 27 29 31 35 36 44 58 67 69 77 78 89 90 91 
#module 1 size: 70 bs: 1.35323e-08
8 9 10 11 12 18 19 20 21 22 23 26 28 30 32 33 34 37 38 39 40 41 42 43 45 46 48 49 50 51 52 53 54 55 56 57 59 60 61 62 63 64 65 66 68 70 71 72 74 75 76 79 80 81 82 83 84 85 86 87 88 92 93 94 95 96 97 98 99 100 
#module 0 size: 70 bs: 0.041329
8 9 10 11 12 18 19 20 21 22 23 26 28 30 32 33 34 37 38 39 40 41 42 43 45 46 48 49 50 51 52 53 54 55 56 57 59 60 61 62 63 64 65 66 68 70 71 72 74 75 76 79 80 81 82 83 84 85 86 87 88 92 93 94 95 96 97 98 99 100 
#module 1 size: 13 bs: 0.00287191
2 3 6 13 14 24 25 47 58 69 77 78 89 
#module 0 size: 70 bs: 0.041329
8 9 10 11 12 18 19 20 21 22 23 26 28 30 32 33 34 37 38 39 40 41 42 43 45 46 48 49 50 51 52 53 54 55 56 57 59 60 61 62 63 64 65 66 68 70 71 72 74 75 76 79 80 81 82 83 84 85 86 87 88 92 93 94 95 96 97 98 99 100 
#module 1 size: 14 bs: 0.081865
2 3 6 13 14 16 24 25 47 58 69 77 78 89 
#module 0 size: 70 bs: 0.041329
8 9 10 11 12 18 19 20 21 22 23 26 28 30 32 33 34 37 38 39 40 41 42 43 45 46 48 49 50 51 52 53 54 55 56 57 59 60 61 62 63 64 65 66 68 70 71 72 74 75 76 79 80 81 82 83 84 85 86 87 88 92 93 94 95 96 97 98 99 100 
#module 1 size: 13 bs: 0.00278753
2 3 6 13 14 24 25 47 58 69 77 78 89 
