#module 0 size: 17 bs: 6.57279e-006
9 10 13 14 17 25 29 31 32 35 36 46 47 56 58 68 99 
#module 1 size: 36 bs: 1.60928e-006
1 2 5 7 8 11 15 16 21 24 27 28 33 40 42 43 45 51 62 67 69 73 74 77 78 79 80 84 85 87 88 89 90 91 94 97 
#module 2 size: 27 bs: 3.6066e-005
4 5 8 12 18 19 22 34 41 42 44 45 50 51 52 55 61 62 64 70 75 77 81 83 84 94 96 
#module 3 size: 21 bs: 5.83046e-005
4 19 26 38 49 53 54 55 61 64 66 70 71 72 76 81 82 86 92 93 96 
#module 0 size: 36 bs: 1.60928e-006
1 2 5 7 8 11 15 16 21 24 27 28 33 40 42 43 45 51 62 67 69 73 74 77 78 79 80 84 85 87 88 89 90 91 94 97 
#module 1 size: 27 bs: 3.6066e-005
4 5 8 12 18 19 22 34 41 42 44 45 50 51 52 55 61 62 64 70 75 77 81 83 84 94 96 
#module 2 size: 21 bs: 0.000100223
4 19 26 38 49 53 54 55 61 64 66 70 71 72 76 81 82 86 92 93 96 
#module 3 size: 5 bs: 0.00274701
9 10 13 31 46 
#module 4 size: 4 bs: 0.0494654
36 47 58 99 
#module 0 size: 36 bs: 3.6066e-005
1 2 5 7 8 11 15 16 21 24 27 28 33 40 42 43 45 51 62 67 69 73 74 77 78 79 80 84 85 87 88 89 90 91 94 97 
#module 1 size: 38 bs: 5.82777e-005
1 3 6 9 11 14 16 17 20 23 24 25 29 30 31 32 33 35 36 43 47 56 58 63 68 69 78 80 85 87 88 89 90 91 97 98 99 100 
#module 2 size: 27 bs: 5.83046e-005
4 5 8 12 18 19 22 34 41 42 44 45 50 51 52 55 61 62 64 70 75 77 81 83 84 94 96 
#module 3 size: 21 bs: 1.73145e-010
4 19 26 38 49 53 54 55 61 64 66 70 71 72 76 81 82 86 92 93 96 
#module 4 size: 4 bs: 0.00371749
37 59 60 65 
#module 0 size: 36 bs: 1.58313e-006
1 2 5 7 8 11 15 16 21 24 27 28 33 40 42 43 45 51 62 67 69 73 74 77 78 79 80 84 85 87 88 89 90 91 94 97 
#module 1 size: 21 bs: 3.6066e-005
4 19 26 38 49 53 54 55 61 64 66 70 71 72 76 81 82 86 92 93 96 
#module 2 size: 27 bs: 0.0228876
4 5 8 12 18 19 22 34 41 42 44 45 50 51 52 55 61 62 64 70 75 77 81 83 84 94 96 
#module 3 size: 5 bs: 0.00274701
9 10 13 31 46 
#module 4 size: 4 bs: 0.0494654
36 47 58 99 
#module 0 size: 36 bs: 3.6066e-005
1 2 5 7 8 11 15 16 21 24 27 28 33 40 42 43 45 51 62 67 69 73 74 77 78 79 80 84 85 87 88 89 90 91 94 97 
#module 1 size: 38 bs: 5.82778e-005
1 3 6 9 11 14 16 17 20 23 24 25 29 30 31 32 33 35 36 43 47 56 58 63 68 69 78 80 85 87 88 89 90 91 97 98 99 100 
#module 2 size: 27 bs: 0.000100223
4 5 8 12 18 19 22 34 41 42 44 45 50 51 52 55 61 62 64 70 75 77 81 83 84 94 96 
#module 3 size: 21 bs: 1.14143e-010
4 19 26 38 49 53 54 55 61 64 66 70 71 72 76 81 82 86 92 93 96 
#module 4 size: 4 bs: 0.00371749
37 59 60 65 
#module 0 size: 36 bs: 3.6066e-005
1 2 5 7 8 11 15 16 21 24 27 28 33 40 42 43 45 51 62 67 69 73 74 77 78 79 80 84 85 87 88 89 90 91 94 97 
#module 1 size: 38 bs: 5.82777e-005
1 3 6 9 11 14 16 17 20 23 24 25 29 30 31 32 33 35 36 43 47 56 58 63 68 69 78 80 85 87 88 89 90 91 97 98 99 100 
#module 2 size: 21 bs: 0.0163147
4 19 26 38 49 53 54 55 61 64 66 70 71 72 76 81 82 86 92 93 96 
#module 3 size: 27 bs: 1.73146e-010
4 5 8 12 18 19 22 34 41 42 44 45 50 51 52 55 61 62 64 70 75 77 81 83 84 94 96 
#module 4 size: 4 bs: 0.00371749
37 59 60 65 
#module 0 size: 30 bs: 1.44426e-005
1 3 6 11 14 16 17 20 23 24 25 29 30 32 33 35 43 56 63 68 69 78 80 85 88 89 90 97 98 100 
#module 1 size: 34 bs: 9.91784e-005
1 2 5 7 8 11 15 16 21 24 27 28 33 40 43 45 51 62 67 69 73 74 77 78 79 80 84 85 87 88 89 90 91 97 
#module 2 size: 21 bs: 0.0212194
4 19 26 38 49 53 54 55 61 64 66 70 71 72 76 81 82 86 92 93 96 
#module 3 size: 27 bs: 1.14143e-010
4 5 8 12 18 19 22 34 41 42 44 45 50 51 52 55 61 62 64 70 75 77 81 83 84 94 96 
#module 4 size: 4 bs: 0.0494653
36 47 58 99 
#module 0 size: 34 bs: 9.91783e-005
1 2 5 7 8 11 15 16 21 24 27 28 33 40 43 45 51 62 67 69 73 74 77 78 79 80 84 85 87 88 89 90 91 97 
#module 1 size: 36 bs: 6.19114e-005
1 3 6 9 11 14 16 17 20 23 24 25 29 30 31 32 33 35 36 43 47 56 58 63 68 69 78 80 85 88 89 90 97 98 99 100 
#module 2 size: 21 bs: 0.0210224
4 19 26 38 49 53 54 55 61 64 66 70 71 72 76 81 82 86 92 93 96 
#module 3 size: 27 bs: 1.14143e-010
4 5 8 12 18 19 22 34 41 42 44 45 50 51 52 55 61 62 64 70 75 77 81 83 84 94 96 
#module 0 size: 34 bs: 9.91784e-005
1 2 5 7 8 11 15 16 21 24 27 28 33 40 43 45 51 62 67 69 73 74 77 78 79 80 84 85 87 88 89 90 91 97 
#module 1 size: 36 bs: 6.19114e-005
1 3 6 9 11 14 16 17 20 23 24 25 29 30 31 32 33 35 36 43 47 56 58 63 68 69 78 80 85 88 89 90 97 98 99 100 
#module 2 size: 27 bs: 0.000100223
4 5 8 12 18 19 22 34 41 42 44 45 50 51 52 55 61 62 64 70 75 77 81 83 84 94 96 
#module 3 size: 21 bs: 1.47483e-010
4 19 26 38 49 53 54 55 61 64 66 70 71 72 76 81 82 86 92 93 96 
#module 4 size: 4 bs: 0.00371749
37 59 60 65 
#module 0 size: 36 bs: 3.6066e-005
1 2 5 7 8 11 15 16 21 24 27 28 33 40 42 43 45 51 62 67 69 73 74 77 78 79 80 84 85 87 88 89 90 91 94 97 
#module 1 size: 38 bs: 5.82777e-005
1 3 6 9 11 14 16 17 20 23 24 25 29 30 31 32 33 35 36 43 47 56 58 63 68 69 78 80 85 87 88 89 90 91 97 98 99 100 
#module 2 size: 27 bs: 0.000100223
4 5 8 12 18 19 22 34 41 42 44 45 50 51 52 55 61 62 64 70 75 77 81 83 84 94 96 
#module 3 size: 21 bs: 1.47484e-010
4 19 26 38 49 53 54 55 61 64 66 70 71 72 76 81 82 86 92 93 96 
#module 0 size: 36 bs: 3.6066e-005
1 2 5 7 8 11 15 16 21 24 27 28 33 40 42 43 45 51 62 67 69 73 74 77 78 79 80 84 85 87 88 89 90 91 94 97 
#module 1 size: 38 bs: 2.91217e-005
1 3 6 9 11 14 16 17 20 23 24 25 29 30 31 32 33 35 36 43 47 56 58 63 68 69 78 80 85 87 88 89 90 91 97 98 99 100 
#module 2 size: 27 bs: 0.000100223
4 5 8 12 18 19 22 34 41 42 44 45 50 51 52 55 61 62 64 70 75 77 81 83 84 94 96 
#module 3 size: 21 bs: 1.47483e-010
4 19 26 38 49 53 54 55 61 64 66 70 71 72 76 81 82 86 92 93 96 
#module 0 size: 34 bs: 9.91784e-005
1 2 5 7 8 11 15 16 21 24 27 28 33 40 43 45 51 62 67 69 73 74 77 78 79 80 84 85 87 88 89 90 91 97 
#module 1 size: 36 bs: 3.0934e-005
1 3 6 9 11 14 16 17 20 23 24 25 29 30 31 32 33 35 36 43 47 56 58 63 68 69 78 80 85 88 89 90 97 98 99 100 
#module 2 size: 27 bs: 0.000100223
4 5 8 12 18 19 22 34 41 42 44 45 50 51 52 55 61 62 64 70 75 77 81 83 84 94 96 
#module 3 size: 21 bs: 1.73145e-010
4 19 26 38 49 53 54 55 61 64 66 70 71 72 76 81 82 86 92 93 96 
#module 0 size: 17 bs: 6.57279e-006
9 10 13 14 17 25 29 31 32 35 36 46 47 56 58 68 99 
#module 1 size: 36 bs: 1.58313e-006
1 2 5 7 8 11 15 16 21 24 27 28 33 40 42 43 45 51 62 67 69 73 74 77 78 79 80 84 85 87 88 89 90 91 94 97 
#module 2 size: 27 bs: 3.6066e-005
4 5 8 12 18 19 22 34 41 42 44 45 50 51 52 55 61 62 64 70 75 77 81 83 84 94 96 
#module 3 size: 21 bs: 0.000100223
4 19 26 38 49 53 54 55 61 64 66 70 71 72 76 81 82 86 92 93 96 
#module 0 size: 36 bs: 3.6066e-005
1 2 5 7 8 11 15 16 21 24 27 28 33 40 42 43 45 51 62 67 69 73 74 77 78 79 80 84 85 87 88 89 90 91 94 97 
#module 1 size: 38 bs: 5.82777e-005
1 3 6 9 11 14 16 17 20 23 24 25 29 30 31 32 33 35 36 43 47 56 58 63 68 69 78 80 85 87 88 89 90 91 97 98 99 100 
#module 2 size: 21 bs: 0.0163147
4 19 26 38 49 53 54 55 61 64 66 70 71 72 76 81 82 86 92 93 96 
#module 3 size: 27 bs: 1.47484e-010
4 5 8 12 18 19 22 34 41 42 44 45 50 51 52 55 61 62 64 70 75 77 81 83 84 94 96 
#module 0 size: 17 bs: 6.57279e-006
9 10 13 14 17 25 29 31 32 35 36 46 47 56 58 68 99 
#module 1 size: 36 bs: 1.60928e-006
1 2 5 7 8 11 15 16 21 24 27 28 33 40 42 43 45 51 62 67 69 73 74 77 78 79 80 84 85 87 88 89 90 91 94 97 
#module 2 size: 21 bs: 3.6066e-005
4 19 26 38 49 53 54 55 61 64 66 70 71 72 76 81 82 86 92 93 96 
#module 3 size: 27 bs: 0.0476027
4 5 8 12 18 19 22 34 41 42 44 45 50 51 52 55 61 62 64 70 75 77 81 83 84 94 96 
#module 0 size: 17 bs: 6.57279e-006
9 10 13 14 17 25 29 31 32 35 36 46 47 56 58 68 99 
#module 1 size: 36 bs: 1.60928e-006
1 2 5 7 8 11 15 16 21 24 27 28 33 40 42 43 45 51 62 67 69 73 74 77 78 79 80 84 85 87 88 89 90 91 94 97 
#module 2 size: 27 bs: 3.6066e-005
4 5 8 12 18 19 22 34 41 42 44 45 50 51 52 55 61 62 64 70 75 77 81 83 84 94 96 
#module 3 size: 21 bs: 0.000100223
4 19 26 38 49 53 54 55 61 64 66 70 71 72 76 81 82 86 92 93 96 
#module 0 size: 17 bs: 1.2823e-006
9 10 13 14 17 25 29 31 32 35 36 46 47 56 58 68 99 
#module 1 size: 36 bs: 1.58313e-006
1 2 5 7 8 11 15 16 21 24 27 28 33 40 42 43 45 51 62 67 69 73 74 77 78 79 80 84 85 87 88 89 90 91 94 97 
#module 2 size: 27 bs: 3.6066e-005
4 5 8 12 18 19 22 34 41 42 44 45 50 51 52 55 61 62 64 70 75 77 81 83 84 94 96 
#module 3 size: 21 bs: 1.73145e-010
4 19 26 38 49 53 54 55 61 64 66 70 71 72 76 81 82 86 92 93 96 
#module 4 size: 8 bs: 8.71568e-005
26 39 48 54 59 60 65 95 
#module 0 size: 36 bs: 3.6066e-005
1 2 5 7 8 11 15 16 21 24 27 28 33 40 42 43 45 51 62 67 69 73 74 77 78 79 80 84 85 87 88 89 90 91 94 97 
#module 1 size: 38 bs: 2.91217e-005
1 3 6 9 11 14 16 17 20 23 24 25 29 30 31 32 33 35 36 43 47 56 58 63 68 69 78 80 85 87 88 89 90 91 97 98 99 100 
#module 2 size: 27 bs: 6.8782e-005
4 5 8 12 18 19 22 34 41 42 44 45 50 51 52 55 61 62 64 70 75 77 81 83 84 94 96 
#module 3 size: 21 bs: 1.71246e-010
4 19 26 38 49 53 54 55 61 64 66 70 71 72 76 81 82 86 92 93 96 
#module 0 size: 30 bs: 1.44585e-005
1 3 6 11 14 16 17 20 23 24 25 29 30 32 33 35 43 56 63 68 69 78 80 85 88 89 90 97 98 100 
#module 1 size: 34 bs: 9.91784e-005
1 2 5 7 8 11 15 16 21 24 27 28 33 40 43 45 51 62 67 69 73 74 77 78 79 80 84 85 87 88 89 90 91 97 
#module 2 size: 27 bs: 6.8782e-005
4 5 8 12 18 19 22 34 41 42 44 45 50 51 52 55 61 62 64 70 75 77 81 83 84 94 96 
#module 3 size: 21 bs: 1.47483e-010
4 19 26 38 49 53 54 55 61 64 66 70 71 72 76 81 82 86 92 93 96 
#module 4 size: 3 bs: 0.00371371
10 13 46 
#module 0 size: 30 bs: 1.33752e-005
1 3 6 11 14 16 17 20 23 24 25 29 30 32 33 35 43 56 63 68 69 78 80 85 88 89 90 97 98 100 
#module 1 size: 34 bs: 9.91784e-005
1 2 5 7 8 11 15 16 21 24 27 28 33 40 43 45 51 62 67 69 73 74 77 78 79 80 84 85 87 88 89 90 91 97 
#module 2 size: 27 bs: 0.000100223
4 5 8 12 18 19 22 34 41 42 44 45 50 51 52 55 61 62 64 70 75 77 81 83 84 94 96 
#module 3 size: 8 bs: 6.60057e-005
26 39 48 54 59 60 65 95 
#module 4 size: 21 bs: 1.73146e-010
4 19 26 38 49 53 54 55 61 64 66 70 71 72 76 81 82 86 92 93 96 
#module 5 size: 5 bs: 0.00274701
9 10 13 31 46 
